8
0
4 6 0 0 0 0 0 0 6 0 1 1 1 1 0 6 0 1 1 1 1 0 6 0 0 0 0 0 0 1 4 2 1 2 2 4 1
1
8 8 5 5 0 0 0 5 5 5 8 5 5 0 1 0 5 5 5 8 5 5 0 1 0 0 0 0 8 0 0 0 1 1 1 1 0 8 0 1 1 1 1 0 0 0 8 0 0 0 0 1 0 5 5 8 5 5 5 0 1 0 5 5 8 5 5 5 0 0 0 5 5 4 1 4 3 1 4 6 6 3 4 3 3 3 4 4 5 5 3 4 4
2
8 6 5 5 0 0 0 0 6 5 5 0 1 1 0 7 5 0 0 1 1 0 0 7 5 0 1 1 2 1 0 8 0 0 1 2 1 1 0 0 8 0 1 1 0 2 2 1 0 8 0 1 1 4 1 1 1 0 8 0 0 0 0 0 0 0 0 4 3 1 4 1 4 2 5 3 4 4 3 3 4 4 5 5 5 3 6
3
10 10 5 5 5 5 5 0 0 0 0 5 10 5 5 5 0 0 0 1 1 0 0 10 0 0 0 0 1 1 1 1 1 0 10 0 1 1 0 1 1 0 1 1 0 10 0 1 1 1 1 1 1 1 1 0 10 0 1 1 0 0 1 0 0 0 0 10 0 0 1 0 0 1 1 0 5 5 10 0 1 1 1 1 1 1 0 5 5 10 0 1 1 1 0 1 1 0 5 5 10 0 0 0 0 0 0 0 0 5 5 5 2 7 4 4 5 4 5 5 7 2 5 2 6 3 4 4 3 5 3 7 4 7 2
4
8 7 0 0 0 0 0 0 5 7 0 1 1 1 1 0 5 7 0 1 1 0 1 0 5 7 0 1 1 0 1 0 5 7 0 1 1 1 1 0 0 7 0 1 1 1 1 1 0 7 0 0 0 1 1 1 0 7 5 5 0 0 0 0 0 4 1 3 1 4 3 4 3 6 4 2 3 2 4 2 5 4 5 1 5
5
9 7 0 0 0 0 0 0 5 7 0 1 1 1 1 0 5 7 0 1 0 0 1 0 5 7 0 1 1 0 1 0 5 7 0 1 1 1 1 0 0 7 0 1 1 1 1 1 0 7 0 0 1 1 1 1 0 7 5 0 0 0 1 1 0 7 5 5 5 0 0 0 0 4 1 1 1 3 1 5 2 5 4 1 2 2 4 3 4 4 2 1 1
6
8 8 0 0 0 0 0 0 0 0 8 0 1 1 1 0 1 1 0 8 0 0 1 1 1 1 1 0 8 0 1 1 1 1 1 1 0 8 0 1 1 0 1 1 0 0 8 0 0 1 1 1 1 0 5 8 5 0 0 0 1 1 0 5 8 5 5 5 0 0 0 0 5 4 4 2 4 3 4 5 6 2 4 2 2 3 2 3 3 5 3 1 1
7
7 8 5 5 0 0 0 0 5 5 8 5 5 0 1 1 0 0 0 8 0 0 0 1 1 1 1 0 8 0 1 1 1 1 1 1 0 8 0 1 1 1 0 1 1 0 8 0 0 0 1 1 1 0 0 8 5 5 0 0 0 0 0 5 3 3 5 4 2 5 4 3 2 3 3 3 4 3 1 3
