18
0
4 6 0 0 0 0 0 0 6 0 1 1 1 1 0 6 0 1 1 1 1 0 6 0 0 0 0 0 0 1 4 2 1 2 2 4 1
2
8 8 5 5 0 0 0 5 5 5 8 5 5 0 1 0 5 5 5 8 5 5 0 1 0 0 0 0 8 0 0 0 1 1 1 1 0 8 0 1 1 1 1 0 0 0 8 0 0 0 0 1 0 5 5 8 5 5 5 0 1 0 5 5 8 5 5 5 0 0 0 5 5 4 1 4 3 1 4 6 6 3 4 3 3 3 4 4 5 5 3 4 4
13
8 6 5 5 0 0 0 0 6 5 5 0 1 1 0 7 5 0 0 1 1 0 0 7 5 0 1 1 2 1 0 8 0 0 1 2 1 1 0 0 8 0 1 1 0 2 2 1 0 8 0 1 1 4 1 1 1 0 8 0 0 0 0 0 0 0 0 4 3 1 4 1 4 2 5 3 4 4 3 3 4 4 5 5 5 3 6
12
10 10 5 5 5 5 5 0 0 0 0 5 10 5 5 5 0 0 0 1 1 0 0 10 0 0 0 0 1 1 1 1 1 0 10 0 1 1 0 1 1 0 1 1 0 10 0 1 1 1 1 1 1 1 1 0 10 0 1 1 0 0 1 0 0 0 0 10 0 0 1 0 0 1 1 0 5 5 10 0 1 1 1 1 1 1 0 5 5 10 0 1 1 1 0 1 1 0 5 5 10 0 0 0 0 0 0 0 0 5 5 5 2 7 4 4 5 4 5 5 7 2 5 2 6 3 4 4 3 5 3 7 4 7 2
9
8 7 0 0 0 0 0 0 5 7 0 1 1 1 1 0 5 7 0 1 1 0 1 0 5 7 0 1 1 0 1 0 5 7 0 1 1 1 1 0 0 7 0 1 1 1 1 1 0 7 0 0 0 1 1 1 0 7 5 5 0 0 0 0 0 4 1 3 1 4 3 4 3 6 4 2 3 2 4 2 5 4 5 1 5
10
9 7 0 0 0 0 0 0 5 7 0 1 1 1 1 0 5 7 0 1 0 0 1 0 5 7 0 1 1 0 1 0 5 7 0 1 1 1 1 0 0 7 0 1 1 1 1 1 0 7 0 0 1 1 1 1 0 7 5 0 0 0 1 1 0 7 5 5 5 0 0 0 0 4 1 1 1 3 1 5 2 5 4 1 2 2 4 3 4 4 2 1 1
11
8 8 0 0 0 0 0 0 0 0 8 0 1 1 1 0 1 1 0 8 0 0 1 1 1 1 1 0 8 0 1 1 1 1 1 1 0 8 0 1 1 0 1 1 0 0 8 0 0 1 1 1 1 0 5 8 5 0 0 0 1 1 0 5 8 5 5 5 0 0 0 0 5 4 4 2 4 3 4 5 6 2 4 2 2 3 2 3 3 5 3 1 1
5
7 8 5 5 0 0 0 0 5 5 8 5 5 0 1 1 0 0 0 8 0 0 0 1 1 1 1 0 8 0 1 1 1 1 1 1 0 8 0 1 1 1 0 1 1 0 8 0 0 0 1 1 1 0 0 8 5 5 0 0 0 0 0 5 3 3 5 4 2 5 4 3 2 3 3 3 4 3 1 3
3
6 6 0 0 0 0 0 0 6 0 1 1 1 1 0 6 0 1 1 1 1 0 6 0 1 1 1 1 0 6 0 0 0 1 1 0 6 5 5 0 0 0 0 3 1 1 1 2 2 1 3 2 2 2 3 3 1 1 3
1
6 8 0 0 0 0 0 0 0 0 8 0 1 1 1 1 1 1 0 8 0 1 1 1 1 1 1 0 8 0 1 1 1 1 1 1 0 8 0 1 1 1 1 1 1 0 8 0 0 0 0 0 0 0 0 2 5 4 6 1 2 2 3 5 1 1 2
14
9 8 5 5 0 0 0 0 5 5 8 5 5 0 1 1 0 5 5 8 0 0 0 1 1 0 0 0 8 0 1 1 1 1 1 1 0 8 0 1 1 1 1 1 1 0 8 0 1 1 1 1 1 1 0 8 0 0 0 1 1 0 0 0 8 5 5 0 1 1 0 5 5 8 5 5 0 0 0 0 5 5 6 1 4 2 4 3 4 4 4 5 4 6 4 6 2 4 3 4 4 3 4 5 5 3 5 5 1 4
4
8 8 5 5 5 0 0 0 0 0 8 0 0 0 0 1 1 1 0 8 0 1 1 0 0 1 1 0 8 0 1 1 1 1 1 1 0 8 0 0 1 0 0 1 1 0 8 5 0 1 1 1 0 1 0 8 5 0 0 0 1 1 1 0 8 5 5 5 0 0 0 0 0 3 4 1 5 1 6 1 3 2 3 5 2 6 5 2 2
6
7 7 5 5 5 0 0 0 0 7 5 0 0 0 1 1 0 7 0 0 1 1 1 1 0 7 0 1 1 1 1 0 0 7 0 1 0 1 1 0 5 7 0 1 1 1 1 0 5 7 0 0 0 0 0 0 5 4 2 2 4 4 4 5 5 2 4 2 5 3 2 3 3 4 2 5 1
7
8 6 5 0 0 0 0 5 6 5 0 1 1 0 5 6 0 0 1 1 0 0 6 0 1 1 1 1 0 6 0 1 1 1 1 0 6 0 1 1 0 1 0 6 0 0 1 1 1 0 6 5 0 0 0 0 0 3 1 3 3 4 4 5 3 2 3 2 4 2 5 1 5
8
8 7 0 0 0 0 0 5 5 7 0 1 1 1 0 5 5 7 0 1 1 1 0 0 0 7 0 1 1 1 1 1 0 7 0 1 1 1 1 0 0 7 0 0 0 1 1 0 5 7 5 5 0 1 1 0 5 7 5 5 0 0 0 0 5 4 2 3 3 3 4 3 5 3 4 2 3 3 2 3 4 3 5 3 1
17
10 13 1 0 0 0 0 0 0 0 0 0 0 0 5 13 0 0 1 1 1 1 1 1 1 1 1 0 5 13 0 1 1 0 0 0 0 0 0 0 1 0 0 13 0 1 0 0 1 1 1 1 1 1 1 1 0 13 0 1 0 1 1 0 0 1 1 1 1 1 0 13 0 1 0 1 1 1 1 1 0 0 0 0 0 13 0 1 0 1 0 1 1 1 0 5 5 5 5 13 0 1 1 1 1 1 1 1 0 5 5 5 5 13 0 0 0 0 0 1 1 0 0 5 5 5 5 13 5 5 5 5 0 0 0 0 5 5 5 5 5 8 4 3 5 3 6 3 7 3 7 4 7 5 7 6 7 7 8 2 7 3 5 5 7 6 5 7 4 8 3 10 3 10 4 11 4
16
12 14 5 5 5 5 0 0 0 0 0 0 5 5 5 5 14 5 5 0 0 0 1 1 1 1 0 0 0 5 5 14 5 5 0 1 1 1 0 1 1 1 1 0 0 0 14 5 5 0 1 1 1 1 1 1 1 1 1 1 0 14 5 5 0 1 1 1 1 0 1 1 1 1 1 0 14 5 5 0 0 1 1 1 1 1 1 1 1 1 0 14 0 0 0 0 0 0 1 0 1 0 0 0 0 0 14 0 1 1 1 1 0 1 1 1 0 5 5 5 5 14 0 1 0 1 1 1 1 1 0 0 5 5 5 5 14 0 1 1 1 1 1 0 1 0 5 5 5 5 5 14 0 1 1 1 1 1 1 1 0 5 5 5 5 5 14 0 0 0 0 0 0 0 0 0 5 5 5 5 5 13 1 7 1 8 1 9 1 10 2 7 2 9 2 10 3 8 3 9 3 10 4 8 4 9 4 10 13 4 4 5 4 5 9 6 3 6 7 7 2 7 5 7 8 8 4 8 6 10 3 11 3 11 5 3 8
15
8 7 5 5 5 0 0 0 0 7 0 0 0 0 1 1 0 7 0 1 1 1 1 1 0 7 0 1 1 1 1 1 0 7 0 1 1 1 1 1 0 7 0 1 1 1 1 0 0 7 0 0 1 1 1 0 5 7 5 0 0 0 0 0 5 6 1 4 2 4 3 2 3 4 3 6 4 4 6 1 4 2 4 3 2 3 4 3 5 4 4 2 6
